R 1000 750

NO ./textures/wall66.xpm
SO ./textures/bricks.xpm
WE ./textures/greystone.xpm
EA ./textures/mud.xpm

S ./textures/barrel.xpm

F 80, 80, 100
C 200, 100, 100

    11111111111
   1001000100001
  10001000102021
 100001100100001
1000000000000021
100221000011111
10022100001
12000000001
122200000001111111111111111111
1100000000000222000022222222221
1000002220000000000000000000021
1000000001000222222222220000001
 100N0000111111111111111111111
  10000000000000222221
   1111111111111111111


