R 500 500

NO ./textures/wall66.xpm
SO ./textures/bricks.xpm
WE ./textures/greystone.xpm
EA ./textures/mud.xpm

S ./textures/barrel.xpm

F 80, 80, 100
C 200, 100, 100

111111111111
100000001021
100S000010001
1220000010001
11111000100111111111
10000000000000000021
10000100100000000021
11111100100000000001
10000000100000022001
10000000111111111111
100000001
111111111